1111111111111
10001000000C1
1C001P00000E1
1000000000001
1111111111111