1111111111111111111111111
10000000C00000E00P0000C01
10C00000001000000000C0001
1111111111111111111111111