111111111111
1000C0000111
100C00001E01
100P00001101
111111111111