1111111111111111111111111
1E00000000000000000000001
1000000000000000000000001
1000000000000000000000001
1000000001100000000000001
100000000C100000000000011
1000000000100000000000001
1000000000000000000000001
1000000000000000000000001
10000000000000000000000P1
1111111111111111111111111